#######
#     #
# # # #
#     #
# # # #
#     #
#######
