############################################################
#                               ############################
#                               ############################
#  #  #  #  #                                              #
#                               #### ############        ###
#  #  #  #  #                   #### ############        ###
#                               #### ############        ###
#  #  #  #  #                   #### ############        ###
#                               #### ############        ###
#                               #### #######################
#                               +      ###    ###        ###
#                               ###### ### ## ###        ###
#  #  #  #  #                   ###### ### ## ###        ###
#  #  #  #  #                   ######     ##            ###
#  #  #  #  #                   #################        ###
#  #  #  #  #                   ############################
#  #  #  #  #                   ############################
#                               ############################
#                               ############################
#                               ############################
#                               ############################
#                               ############################
#                               ############################
#                               ############################
#                               ############################
#                               ############################
#                               ############################
#                               ############################
#                               ############################
#                               ############################
#                               ############################
#                               ############################
#                               ############################
#                               ############################
#                               ############################
############################################################
