############################################################
#                               ############################
#                               ############################
#  #  #  #  #                                              #
#                               #### ############ ~~~~~~ ###
#  #  #  #  #                   #### ############ ~~~~~~ ###
#                               #### ############ ~~~~~~ ###
#  #  #  #  #                   #### ############ ~~~~~~ ###
#                               #### ############        ###
#                               #### ################g######
#                               +      ###    ###        ###
#                               ###### ### ## ###        ###
#  #  #  #  #                   ###### ### ## ###        ###
#  #  #  #  #                   ######     ##            ###
#  #  #  #  #                   ######ggggg######        ###
#  #  #  #  #                   #          ########## ######
#  #  #  #  #                   g  ~~~~~~  ########## ######
#                               g  ~~~~~~             ######
#                               g  ~~~~~~  #################
#                               g  ~~~~~~  #################
#                               g          #################
#   g#+#gg###g                  ###### #####################
#   #~~~~~~~~#      ~~~~~~      ###### #####################
#   g~~~~~~~~g      ~~~~~~      ###### #####################
#   g~~~~~~~~g      ~~~~~~      ###### #####################
#   #~~~~~~~~#      ~~~~~~      ###### #####################
#   g###gg###g                  +      #####################
#                               ############################
#                               ############################
#   gggggggg                    ############################
#   gggggggg                    ggggggggggggggggggggggg#####
#   gggggggg                    g         ggggggggggggg#####
#                               +         ggggggggggggg#####
#                               g         ggggggggggggg#####
#                               ggggggggggggggggggggggg#####
############################################################
