____________________________________________________________
____________________________________________________________
____________________________________________________________
____________________________________________________________
____________________________________________________________
____________________________________________________________
____________________________________________________________
____________________________________________________________
____________________________________________________________
__________________              _____________________________
__________________              _____________________________
__________________               ____________________________
__________________   >           ____________________________
__________________               ____________________________
__________________               ____________________________
__________________               ____________________________
__________________               ____________________________
__________________               ____________________________
######################### ###################################
######################### ###################################
######################### ######      #######################
######################### ###### ppppppppp~~~################
#########################        ppppppppp~~~################
######################### ###### ppppppppp~~~################
######################### ######      #######################
######################### ###################################
######################### ###################################
########################   #########______###################
#######################            g_#__#_###################
#######################     ########___#__###################
########################   ##################################
######################### ###################################
#############################################################
#############################################################
#############################################################
#############################################################
