############################################################
#                 #________#    ############################
#                 +       _#    ############################
#  #  #  #  #     #______ _#                               #
#                 #______ _#    #### ############ ~~~~~~ ###
#  #  #  #  #     #______ _#    #### ############ ~~~~~~ ###
#                 #______ _#    #### ############ ~~~~~~ ###
#  #  #  #  #     +       _#    #### ############ ~~~~~~ ###
#                 #       _#    #### ############        ###
####+##########+####+########+####### ################g######
#                #               +      ###    ###        ###
#                #               ###### ### ## ###        ###
#  #  #  #  #    +   >           ###### ### ## ###        ###
#  #  #  #  #    #               gggggg     ##            ###
#  #  #  #  #    #               ######ggggg######        ###
#  #  #  #  #    #               +          ########## ######
#  #  #  #  #    #               #  ~~~~~~  ########## ######
#                #               #  ~~~~~~             ######
#                #########+#######  ~~~~~~  #################
#                #               g  ~~~~~~  #################
#                #               g          #################
#   g#+#gg###g   #               ###### #####################
#   #~~~~~~~~#   #   ~~~~~~      ###### #####################
#   g~~~~~~~~g   #   ~~~~~~      ###### #####################
#   g~~~~~~~~g   #   ~~~~~~      ###### #####################
#   #~~~~~~~~#   +   ~~~~~~      ###### #####################
#   g###gg###g   #               +      #####################
#                #               ############################
#                #               ############################
#   gggggggg     #               ############################
#   gggggggg     #               ggggggggggggggggggggggg#####
#   gggggggg     #               g         ggggggggggggg#####
#                #               +         ggggggggggggg#####
#                #               g         ggggggggggggg#####
#                #               ggggggggggggggggggggggg#####
#############################################################
